111111111111111
101000000000001
101111110111101
100000000000101
111111111110101
100000000010101
101111000000101
100011111111101
111010000000001
101100111110111
100000000000001
110111010101011
100100010100001
1000100100010$1
111111111111111